
0000000000
0000000000
0001400000
0113331110
0155255110
0011111000
0125552100
0111111100
0000000000
0000000000