0000000000
0001400000
0113331110
0155255110
0011111000
012555210
011111110
000000000