
0000000000
0000000000
0011111100
0011111100
0013111100
0011141100
0011112100
0011111100
0000000000
0000000000