
0000000000
0011211000
0115251100
0130203110
0131113110
0000000110
0111000110
0132323110
0012421100
0000000000