
0000000000
0000011000
0000131000
0000151000
0001224000
0001151100
0000031100
0000011000
0000000000
0000000000