
0000000000
0000000000
0001110000
0012233100
0011134100
0002010000
0001110000
0000000000
0000000000
0000000000