00000000
001121100
0115251100
0130203110
0131113110
0000000110
0111000110
0132323110
001242110
 0000000